== == == == == == ==
s1 s1 s1 s1 s1 s1 s1
s1 s1 s1 s1 s1 s1 s1
s1 s1 s1 s1 s1 s1 s1
s1 o1 xx s1 xx o1 s1
o1 xx s1 xx s1 xx o1
xx b1 xx xx xx b1 xx