== == == == == == == == ==
s2 b1 s9 s9 b1 s9 s9 b1 s2
xx
xx
xx ta tb tc td te tf tg xx
xx
xx
o9 o9 o9 o9 o9 o9 o9 o9 o9
s9 s9 s9 s9 s9 s9 s9 s9 s9
s5 tg s5 te s5 tc s5 ta s5
s5 s5 s5 s5 s5 s5 s5 s5 s5
xx td xx tb xx xx tf xx xx